###################
#E#   #           #
# # # # ######### #
# # # #       # # #
# # # ####### # ###
# # #         #   #
# # ######### # # #
# #      #    # # #
# ###### # #### # #
#        #      # #
################# #
#            #    #
# ##### #### # ####
# #   # #    # #  #
### # # # #### ## #
#S  #   #         #
###################